판매 가격: 판매 가격(달러)
MSSubClass: 빌딩 클래스
MSZoning: 일반 구역 분류
로트 전면: 건물과 연결된 거리의 선형 피트
로트 면적: 평방 피트 단위의 로트 크기
도로: 도로 접근 유형
골목: 골목 접근 유형
LotShape: 특성의 일반 모양
Land Contour: 특성의 평탄도
유틸리티: 사용 가능한 유틸리티 유형
LotConfig: Lot구성
토지 경사: 재산 경사
이웃: Amescity 제한 내 물리적 위치
상태 1: 주요 도로 또는 철도와의 근접성
상태 2: 주요 도로 또는 철도와의 근접성(초가 존재하는 경우)
블록 유형: 주거형태
하우스 스타일: 주거 스타일
전체 품질: 전체 재료 및 마감 품질
전체 초: 종합상태등급
제조연도: 원래 시공일
YearRemodAdd: 리모델링 날짜
지붕 스타일: 지붕의 종류
지붕 매트: 지붕 재료
외부 1차: 주택 외부 피복
외부 2차: 주택 외부 피복(하나 이상의 재료인 경우)
MasVnrType: 석공 베니어 유형
MasVnr 면적: 평방 피트의 석조 베니어 구역
ExterQual: 외장재 품질
ExternCond: 외부 소재의 현재 상태
기초: 기초의 종류
BsmtQual: 지하실 높이
Bsmt Cond: 지하실의 일반적인 상태
Bsmt 노출: 워크아웃 또는 정원 수준의 지하 벽
BsmtFinType1: 지하 마감 구역의 품질
BsmtFinSF1: 타입 1 마감 평방 피트
BsmtFinType2: 두 번째 마감 영역의 품질(있는 경우)
BsmtFinSF2: 타입 2 마감 평방 피트
BsmtUnfSF: 지하실 면적의 미완성 평방 피트
총 BsmtSF: 지하실 면적의 총 평방 피트
난방: 난방의 종류
난방QC: 난방 품질 및 상태
센트럴 에어: 중앙 에어컨
전기: 전기 시스템
1층 SF: 1층 평방 피트
2층 SF: 2층 평방 피트
낮은 Qual FinSF: 낮은 품질의 마감 평방 피트(모든 층)
GrLiv 면적: 1등급 이상(지상) 생활 면적 평방 피트
Bsmt 전체 욕실: 지하실 전체 욕실
Bsmt 하프 배스: 지하 반 욕실
풀 배스: 등급 이상의 전체 욕실
반욕: 등급 이상의 반욕
침실: 지하 1층 이상의 침실 수
주방 : 주방 개수
키친퀄 : 주방퀄리티
TotTrmsAbvGrd: 등급 이상의 총 객실(욕실은 포함되지 않음)
기능: 홈 기능 등급
벽난로: 벽난로 개수
벽난로 큐: 벽난로 품질
차고 유형: 차고 위치
Garage YrBlt: 차고가 건설된 연도
차고 마감: 차고의 내부 마감
차고지 자동차: 자동차 용량의 차고
차고 면적: 평방 피트의 차고 크기
Garage Qual: Garage 품질
차고 2: 차고 상태
포장된 드라이브: 포장된 진입로
우드덱SF: 목재 데크 면적(평방 피트
오픈포치SF: 평방 피트의 오픈포치 구역
폐쇄형 현관: 평방 피트의 폐쇄형 현관 구역
3SsnPorch: 평방 피트의 3계절 현관 구역
스크린 포치: 평방 피트의 스크린 포치 영역
수영장 면적: 평방 피트의 수영장 면적
풀 QC: 풀 품질
펜스: 펜스 품질
기타 기능: 기타 범주에서 다루지 않는 기타 기능
MiscVal: $기타 기능의 값
판매된 달: 판매된 달
판매 연도: 판매 연도
판매 유형: 판매유형
판매 조건: 매각조건